(A)
Artifacts - добавляет в игру артефакты как из террарии с уникальными баффами (контент)
Armor Visibility - позволяет отключать и включать видимость брони для себя и других игроков (украшение, удобство)
AI-Improvements - улучшение искусственного интеллекта у мобов. (геймплей)
Armor points - видно показатели брони, даже если они выше алмазной (удобство)
Attribute Fix - позволяет всем атрибутам игры, таким как броня, хп, сопротивление отбрасыванию и так далее увеличить свои максимальные границы во много раз, что помогает правильной работе других модов (геймплей)
Advanced Compass - очень интересная и балансная замена миникарте, добавляет полоску компаса сверху экрана, на которой отображаются игроки, ближайшие мобы, а так же поставленные вейпоинты (геймплей, удобство)
Advancement Plaques - делает получение достижений более эпичным, добавляя красивую анимацию при их выполнении (украшение)


(B)
Born in Chaos - глобальный мод на кучу новых мобов, немного новой брони и инструментов, все это в стиле средневековья (глобал)
Biome Particle Weather - добавляет в каждый биом свою уникальную новую погоду, по типу песчаной бури в пустыне или сильного ветра в саванне + улучшает уже имеющуюся погоду игры (украшение)
Berries and cherries - ягодки и кустики ягодок. чуть оживляет игру (украшение, контент)
Better f3 - улучшенный интерфейс F3 (удобство)
Big oak tree - генерация огромного дерева (очень красиво) (генерация)
Born in Chaos - глобальный мод на новых мобов, броню (после незеритовой), оружие. не влияет на баланс, развитие постепенное. (глобал)
Brutalbosses - рандомный спавн усиленных мобов со своими способностями. усложняет геймплей (геймплей)
By go nether/Incendium - новые биомы и структуры в аду (генерация)
Break Free + Multi mine - позволяет продолжить копание блока, если случайно навел курсор на другой, а так же сохраняет прогресс копания блока при смене инструментов (геймплей)
Bosses of Mass Destruction - добавляет в игру 4 очень круто стилизованных босса, 2 в обычном мире и по одному в каждом оставшемся измерениях, ночной лич, мутировавший цветок, огненная перчатка и кого-то в энде (контент)
Better Respawn - изменяет механику возрождения, теперь после смерти игрок спаунится в пределах 100 блоков от своего места смерти (геймплей)



(C)
Continuity - добавляет поддержку соединения блоков и их света для шейдеров (украшение, библиотека)
CarryOn - дает возможность переносить сундуки и мобов напрямую в руках (удобство)
Camera Overhaul - добавляет покачивание камеры вправо или влево в зависимости от движения персонажа, что добавляет динамики и реалистичности
*updated* - теперь так же добавляет небольшую тряску при копании блоков, взрывах и ударах молнии около игрока 
(украшение)
Chunk loaders - добавляет крафт штук, которые прогружают чанки (может быть полезно для разного рода ферм) (удобство)
Clumps - опыт в одну капельку (удобство, оптимизация)
Customizable elytr - можно красить элитры (украшение)
Corpse - после смерти игрока остается его труп, который так же можно обыскать, чтобы вернуть свои вещи на те же места, где они были изначально (геймплей)
Controlling - помогает со всем, что связано с биндами в игре (удобство)
Curious Lanterns - добавляет возможность повесить лампу себе на пояс, при этом лампа будет излучать динамический свет (удобство)
Centered Crosshair - центрирует перекрестье, чтобы оно находилось идеально по центру экрана (изначально оно было не по центру экрана немного чего нах) (украшение)
Configured - позволяет изменять конфиг модов прямо в игре, только дла forge (удобство)
CleanCut - теперь трава и прочие блоки, не имеющие коллизию не будут мешать игроку ударить моба (удобство)


(D)
Dynamic Crosshair - меняет прицел в зависимости от того, на что в данный момент он наведен (удобство)
Dungeons and Taverns - добавляет много структур с пилладжерами на поверхности и под землей, включая данжи (генерация)
Delightful burgers - крафт бургеров (контент)
Disenchanting - стол разочарования, который переносит зачарования из оружия в книги. мод имбалансный, перед использованием измените крафт этого стола на более тяжелый. (контент, удобство)
Durability tooltip - видно прочность инструмента в числах (удобство)
DSWG Colors of Sky - дает каждому биому свой уникальный цветокор неба, что делает игру намного атмосфернее (украшение)
DashLoader - значительно ускоряет запуск minecraft путем кеширования информации о модах. примечание1: некоторые моды не поддерживают кеширование, но при этом minecraft все равно будет запускаться и работать, но запуск будет медленнее. примечание2: при первом запуске игры она будет запускаться все так же медленно, потому что нужно создать кеш в первый раз, дальнейшие запуски будут намного быстрее
Disable Double Tap to Sprint - убирает надоедливую функцию бега на двойное нажатие W, в игре на это есть кейбинд (удобство)
Dungeon Now Loading - добавляет 4 больших подземелья в игру, в каждом из которых в конце будет босс (контент)
Dungeon Difficulty - усиливает мобов в зависимости от количества игроков на сервере, биома в котором они появились, измерения и так далее, мод имеет множество настроек (геймплей)
Dungeon Crawl - генерирует случайные подземелья, со входом в виде башни, со случайным лутом по миру игры (контент)
Damage Numbers - самый адекватный мод на показ урона по мобам, потому что урон хорошо видно даже издалека (удобство)
Dungeons Content - переносит почти весь контент в виде мобов и биомов из игры minecraft:dungeons в minecraft (контент)


(E)
Embedium - хороший мод на оптимизацию майна на forge (оптимизация)
Embedium Dynamic Light - позволяет работать моду на лампу на поясе, так же добавляет динамическое освещение (удобство, геймплей)
Easy Magic (не стакается с apotheosis) - позволяет рероллить выпавшие зачарования на столе зачарований а также вещи и лазурит на столе сохраняются (удобство)
Easy Anvils - наковальни больше не расходуют все больше опыта за многократную починку предмета + теперь их можно ремонтировать железными блоками + предметы всегда остаются внутри наковальни (удобство)
Easy ShulkerBoxes - улучшает интерфейс использования шалкеров, позволяя взаимодействовать с ним из инвентаря, что делает его конкурентом для рюкзака (удобство)
Explorify - добавляет разные небольшие новые структуры, которые идеально вписываются в мир (генерация)
Electrodynamics - глобальный мод на добавление всякой электрической шняги для улучшения плавки незерита и создания нано брони (глобал, техно)
Explorer's Compass - компас, который позволяет находить нужную структуру в мире (контент, удобство)
Enchantment Descriptions - описания зачарований (удобство)
Experience jars - бутылочки, где можно сохранить свой опыт (контент, удобство)
Exposure - камера и возможность быть фотографом в майнкрафт (контент, украшение)
Eternal Starlight - добавляет некоторые новые структуры, измерения и боссов, которые очень хорошо проработаны, мод под рпг сборки (контент)
End's Phantasm - изменяет метод прохождения энда, изначально игрока будет спаунить на дальних островах, вход на которые раньше был закрыт до убийства дракона, исследуя эти острова нужно найти портал на арену с драконом + добавляет пару новых биомов энда (геймплей)
Effective - добавляет некоторые визуальные эффекты, наподобие minecraft трейлера, например для воды, сундуков под водой, светлячков на болотах и так далее (украшение)
Endless Music - делает фоновую музыку minecraft полностью настраиваемой относительно пауз между треками (украшение)
Euphoria Patches - дополнение для шейдеров Complimentary, которое добавляет очень много крутых визуальных эффектов по типу свечения порталла в энд, кастомизации лавы, цветного освещения блоков и так далее (украшение)
Enemy Banner - после убийства 50 мобов с них выпадает баннер, который дает баффы как в террарии, то есть увеличение урона по мобу и увеличение добычи с моба (геймплей)
Enchanced Celestials - добавит 2 новых события, такие как урожайная и кровавая луна, во время урожайной посевы будут расти намного быстрее, во время кровавой спаунрейт мобов будет увеличен в 3-4 раза (геймплей)
Equipment Compare - позволяет сравнить 2 предмета между собой, наведя на новый предмет и нажав shift (удобство)


(F)
Fruits delight - деревья, с которых падают фрукты. Олегсей (контент, украшение)
Fast boot - ускорение загрузки игры (оптимизация)
Fog - делает более красивый туман, работает во всех измерениях (украшение)
FTB Chunks - очередной мод на миникарту, но в нем есть фича защиты чанков от повреждения мобами (геймплей)
Fog Looks Good Now - улучшает туман, делая его намного красивее и реалистичнее (украшение)
Fireproof Boats - добавляет лодки из адской древесины, которые способны предвигаться по лаве (геймплей)


(G)
Geophilic - меняет подход к генерации лесов и делает их более красивыми (украшение, генерация)
Gravestone Mod - добавляет могилу после смерти игрока и дает ему бумажку с координатами смерти (удобство)
Gravestone x Curious API compat - возвращает на места не только все вещи в инвентаре, а еще и артефакты (удобство)
Goblin Traders - добавляет спавн гоблинов торговцев по миру с торгами на лучшие зачарования, недоступные в ванильной игре (геймплей, контент)
Go Prone - возможность ползти (удобство)
Gui Effect Timer - видно, сколько будет идти эффект, без необходимости октрывать инвентарь (удобство)


(H)
HT's TreeChop - самый балансный мод на мгновенное срубание дерева (удобство)
Hole filler mod - добавляет крафт сфер из разного материала, которые заполняют собой дыры (контент, удобство)
Horses can swim - лошади теперь не такие бесполезные (удобство)


(I)
Iron Chests - добавляет улучшение сундука как хранилища (удобство, контент)
Iron ender chests - улучшение эндер сундуков (удобство, контент)
Iron Furnaces - добавляет улучшение скорости плавки печек (удобство, контент)
Iron barrels - добавляет улучшение бочек (удобство, контент)
Iron bookshelves - добавляет улучшение книжных полок (удобство, контент)
Iron shulker box - добавляет улучшешие шалкеров (удобство, контент)
Iron ladders - добавляет улучшение лестниц (удобство, контент)
Inventory Profiles Next - добавляет возможность быстрой сортировки сундуков и инвентаря + возможность быстрого перемещения всех предметов в сундук (удобство)
Ice and Fire - глобальный мод на новых боссов в виде драконов, циклопов, сирен, медузы горгоны и так далее + куча новой брони и инструментов (глобал)
Immersive UI - добавляет крутые анимации перемещения и выбора предметов в инвентаре (удобство)
Iris Shaders - добавляет поддержку шейдеров в моды по типу sodium или embendium (библиотека, украшение)
Immersive aircraft - самолеты, дирижабли и всякие приблуды к ним (контент)
Immersive machinery - аддон к immersive aircraft, добавляет еще транспорт. например, бур (контент)
Infinity Music - делает эмбиент и музыку с дисков майнкрафта постоянной и не заканчивающейся, все настраивается (удобство)
Invmove - позволяет передвигаться даже с открытым инвентарем (удобство)
Iron Gem's Jewelry - добавляет в игру кучу разных украшений, которые крафтятся с помощью гемов, продающихся у жителей, каждое из украшений дает свой уникальный эффект (геймплей)
Item Scrapper - добавляет стол для разборки предметов, где разбирая предмет ты бьешь по нему молотом с прикольной анимацией (удобство)
Improvable Skills - теперь в разных сундуках можно находить свитки, позволяющие прокачивать 10 новых навыков, они все пассивные и каждый довольно полезен (например скорость копания или урон в пвп), прокачивать их можно через книгу навыков (геймплей)
Item Highlighter - показывает звездочкой новые подобранные предметы в инвентаре (удобство)


(J)
Journeymap - лучшая мини карта для minecraft (удобство)
Just Enough Items - позволяет видеть все предметы и их крафты в инвентаре (удобство)
Jade - объединяет в себе функции показа названия блока и из какого он мода, а так же отображения имени и хп моба при наведении (удобство)


(K)
Keep Some Inventory - после смерти оставляет инструменты и броню на игроке, при этом все другие предметы выпадают, теперь они не разлетаются во все стороны как в ваниле, а собираются в 1 блок, позволяя вещам случайно не сгореть в ближайшей лаве (геймплей)


(L)
Lootr - в многопользовательской игре делает все сундуки уникальными для каждого игрока (удобство)
Lootbeams - добавляет редким предметам майнкрафта лучи нужного цвета, которые подсвечивают их в выброшенном состоянии (украшение, удобство)
L enders Cataclysm - добавляет новых проработанных боссов с уникальным лутом (контент)
Lios overhauled villages - улучшение деревень, выглядят круче (генерация, украшение)
Load my chunks - оптимизация прогрузки чанков (оптимизация)
Lithium - оптимизирует работу сущностей и всех механик майнкрафта, работает вместе с sodium или embedium (оптимизация)
Linear Progression - все, что делает этот мод, меняет крафт око эндера, теперь для его крафта нужно посетить подводный манумент, дворец испытаний, особняк пилладжеров, древний город вардена ну и конечно же незер, это будет весьма кстати, чтобы увидеть весь контент, который добавляет сборка + нельзя заспидранить игру (геймплей)
LUMINOUS - улучшает все биомы игры, добавляя доп элементы по типу камешков, грибов на деревьях, пару новых мобов по типу оленей и немного улучшает генерацию мира (украшение)
Legendary Creatures - добавляет новых враждебных мобов, по типу пугала, которое может напасть на тебя если ты собираешь чужие посевы, слизней, скорпионов и так далее (контент)


(M)
More Culling - убирает рендеринг не только блоков, которые не видит игрок из-за закрытия их другими блоками, а так же убирает рендеринг всего, что не видит игрок (оптимизация)
Model Gap Fix - исправляет микро дыры между текстурами предметов в руке (украшение)
Man of many planes - самолеты (контент)
Mekanism - очередной глобальный техномод, дополняет electrodynamix (глобал, техно)
Metal bundles - 2 жизнь для мешочков. один из вариантов удобного хранилища (контент)
Moog's Soaring Structures - генерация летающих островов с разными строениями (генерация, украшение)
Mutant monsters - добавляет усиленные вариации монстров - мутантов (геймплей)
MoreVanillaArmor - добавляет еще около 10-15 новых сетов брони из ванильных материаллов, некоторые их них обладают уникальными эффектами (контент)
More Artifacts - добавляет еще 30 новых артефактов из игры террария, которые в некоторых случаях могут быть соединены между собой (геймплей)
More Cosmetics - добавляет меню, где можно нацепить на персонажа разные косметические штуки, по типу накидок, шляп, щитов и так далее (украшение)
Multiplayer Bosses - теперь боссы в мультиплеере будут иметь хп в зависимости от игроков + с них выпадает мешочек с лутом отдельно для каждого игрока (геймплей, удобство)
Music Sync - синхронизирует музыку игры у всех игроков на сервере (украшение)
MC Dungeons Enchanting - меняет систему зачарований на систему из minecraft:dungeons (контент)
Majrusz's Progressive Difficulty - добавляет систему прогрессии игры, схожей с terraria, когда игрок попадает в ад, то мир усложняется, когда в край, то он становится еще сложнее, в кратце, появляются группы мобов с их предводителями, так же добавлен новый ивент, как рейд нежиты при убийстве достаточного количества нежити (контент)


(N)
Nature's Compass - компас, который позволяет находить нужный биом в мире (контент, удобство)
Not Enough Animations - добавляет новые анимации некоторым действиям, по типу просмотра карты, лазания по лестнице, поедания еды и т. д. (украшение)


(O)
One Key Miner - дает возможность выкопать всю жилу руды при нажатии shift + лкм, немного экономит время (геймплей, удобство)
Obscure Tooltips - делает вид подсказок предметов намного красивее, так же показывает рендер 3д модельки этого блока/предмета в мире (украшение)


(P)
Paraglider - добавляет параглайдер (слабый аналог элитр) и статуи в деревнях, в которых можно раскачать свое хп до 60 с помощью орбов, которые падают со спавнеров. мод использовать как облегчающий геймплей в сложных сборках (геймплей, контент)
Pet names - рандомные имена прирученным питомцам (украшение)
Phosphor - оптимизирует составляющую освещения в minecraft и фиксит некоторые баги, связанные с ним, так же позволяет быстрее загружать чанки (оптимизация)
Polymorph - если вдруг какие-то 2 мода сделали один и тот же рецепт крафта на 2 разных предмета, позволяет переключаться между ними в верстаке, что очень выручает (удобство)
Panda's Extra Details - добавляет парочку новых анимаций, например анимация открытия двери и люка
Ping Wheel - добавляет возможность пинговать своим друзьям на место, которое ты хочешь указать (удобство)
Pretty Rain - дополняет дождь и снег в майнкрафте, например теперь дождь будет стекать по стенам и на воде будут видны волны от дождя, снег теперь завихряется от ветра, а в пустые теперь вместо отсутствия дождя идет пустынная буря (украшение)
Pufferfish's Skills - добавляет дерево улучшений персонажа, по типу ускорения копания, увеличения урона и так далее (геймплей)
Potion Rings - добавляет кольца дающие базовые эффекты маяка (геймплей)
Passive Shield - теперь щит не будет видно во второй руке до его применения, так же теперь щит добавляет некоторое сопротивление урону при ношении (геймплей)


(Q)
Quality Food - добавляет всей еде из игры что-то по типу тира редкости, который влияет на то, насколько еда на самом деле будет полезна для игрока, например будет давать больше сытости или давать особые эффекты, мод совместим с farmer's delight (геймплей)


(R)
Retraining - реролл торгов у жителя (удобство)
RightClickHarvest - теперь можно нажать пкм на посевы и они соберутся и посадятся одновременно (удобство)
Remove Reloading Screen - убирает надоедливою анимацию при смене текстурпаков или шейдеров (удобство)
Re:Deco - добавляет очень много новых блоков для обустройства дома, например камодов или баночек с растениями (украшение)
Reacharound - улучшает механику строительства, позволяя ставить блоки в воздухе, в недосягаемых местах и еще много чего (геймплей, удобство)
Realm RPG: Fallen Adventures - добавляет во всех измерениях майнкрафта падших скелетов прошлых путешественников, выглядит очень красиво и вписывается в любую рпг сборку (украшение)
Remove Block Outline - убирает обводку блока при наведении на него, может быть полезно для улучшения восприятия игры (украшение)
Respawning Animals - теперь мирные животные так же могут деспауниться и спаунятся немного чаще (удобство, геймплей)


(S)
Sodium - хороший мод на оптимизацию майна на fabric (оптимизация)
Sophisticated Backpacks - бэкпаки с улучшениями, но без доп баффов игрока (контент, удобство)
SkinChanger/SkinRestorer - позволяет менять скины на пиратском сервере (удобство)
Spooky paintings - 27 новых картин (украшение, контент)
Snowy tents - маленькие лагеря в зимних биомах (генерация)
Stackable potions - зелья стакаются (удобство)
Special mobs - усиление мобов за счет увеличения их разнообразия. усложняет геймплей (геймплей)
StepItUp - позволяет на использовать прыжок для того, чтобы забираться на высоту в 1 блок (геймплей)
Simple Uncrafting Table - позволяет просто и быстро разобрать любой предмет из игры на его составляющие, включая любой модовый предмет (геймплей)
SmoothMenu Refabricated - убирает ограничение частоты кадров в главном меню игры, делая его плавнее (украшение)
Serious Player Animations - улучшает все анимации игрока, бега, ходьбы, прыжков, копания и так далее (украшение)
Spider Caves - добавляет биом паучих пещер из игры terraria (контент)
Swing Trough Grass - альтернатива мода CleanCut на forge, позволяет бить врагов сквозь траву (удобство)
Spelunkery - добавляет вариации руд для андезита, диорита и гранита, так же добавляет новые точки интереса в пещеры (контент)
SleepWarp - теперь когда игрок спит, время не скипается, а сильно ускоряется, если этот мод стоит на сервере, то время сильнее ускоряется в зависимости от числа спящих игроков (удобство)
Subtle Effects - добавляет в игру много доп частиц для блоков и действий, которым их не хватает, например пыль сзади игрока от бега, искры от костра и огня душ, пыль светокамня на блоках и так далее (украшение)
Simply Swords - добавляет кучу вариаций оружия ближнего боя, полностью совместим с better combat (контент)


(T)
Tom's Simple Storage - лучшее хранилище для вещей по типу ME системы (удобство, контент)
Traveler's Backpack - бэкпаки с доп баффами игрока и возможностью хранить жидкости (удобство, контент)
Terralith - добавляет около 100 новых биомов, используя ванильные блоки майнкрафта (есть поддержка geophilic) (генерация)
The Frozen Kingdom - зимний данж с неплохим лутом и сложными противниками (генерация)
The graveyard - данжи, блоки, оружие, босс. (глобал)
Trading post - объединяет все торги в некотором радиусе в один торговый блок (удобство, контент)
Tiny Item Animations - добавляет много анимаций в инвентаре, связанных с перемещением и перетаскиванием предметов (украшение)
Tool Tip Fix - делает так, что огромные подсказки на предметах по типу описания зачарования, теперь занимают меньше места (удобство)
Terra Entity - добавляет в игру некоторых боссов из игры terraria (и так же каламити мода), все они хорошо проработаны и анимированны (контент)
Traveller's Titles - теперь при заходе в новый биом на экране будет писаться его название (украшение, удобство)
ToroHealth Damage Indicators - при ударе по мобу показывает твой урон (удобство)
Twigs - добавляет много новых блоков, которые идеально подходят для строительства дома (контент)
Table Of Experience - добавляет стол, способный разбирать ненужные предметы на пузырьки с опытом (удобство)
Tax's Tree Giant - добавляет в каждый биом имеющий деревья свою разновидность огромного дерева (которые лучше чем твой ебаный мод на дуб саня) (украшение)


(U)
Unseen world - новый биом, оружие, мобы (глобал)


(V)
V-Tweaks - добавляет пару фишек в игру, например возможность запитать печь факелом, падение дерева при его рубке снизу или восстановление блоков на месте взрыва крипера (геймплей)


(W)
What Durability? - убирает возможность потери прочности у любых предметов, которые ее имеют (геймплей)
Wthit - показывает навзание блока и из какого он мода (удобство)
Waystones - можно сделать\найти в мире камни, которые связаны между собой. между ними можно перемещаться. (удобство, генерация, контент)


(X)
X-HP - крутой мод на отображение хп у мобов (удобство)
Neat - альтернативный мод на отображение хп (удобство)


(Y)
YUNG's Cave Biomes - добавляет новые биомы в пещерах, в которых есть пара новых мобов, при этом биомы состоят из ванильных блоков (контент)


(Z)

