(A)
Actually Unbreaking - теперь зачарование прочности делает оружие неломаемым (удобство, геймплей)
Advanced Compass — очень интересная и балансная замена миникарте, добавляет полоску компаса сверху экрана, на которой отображаются игроки, ближайшие мобы, а также поставленные вейпоинты (геймплей, удобство)
Advancement Plaques — делает получение достижений более эпичным, добавляя красивую анимацию при их выполнении (украшение)
AI-Improvements — улучшение искусственного интеллекта у мобов (геймплей)
Armor points — видно показатели брони, даже если они выше алмазной (удобство)
Armor Visibility — позволяет отключать и включать видимость брони для себя и других игроков (украшение, удобство)
Artifacts — добавляет в игру артефакты как из террарии с уникальными баффами (контент)
Attribute Fix — позволяет всем атрибутам игры, таким как броня, хп, сопротивление отбрасыванию и так далее увеличить свои максимальные границы во много раз, что помогает правильной работе других модов (геймплей)
Alex's Caves - добавляет новые биомы в пещерах из ванильных блоков (контент)
A Good Place - добавляет прикольную анимацию поставки блока (украшение)
Auto HUD - теперь если элемент худа игры в данный момент не нужен (например полное здоровье или шкала голода), то он скрывается (украшение)
*примечание* несовместим с ArmorPoints


(B)
Berries and cherries — ягодки и кустики ягодок. Чуть оживляет игру (украшение, контент)
Better f3 — улучшенный интерфейс F3 (удобство)
Better Combat - улучшает систему боевки в игре (контент)
Better Creeper Mod - теперь криперы не наносят повреждения местности и вашим вещам (удобство, геймплей)
Better Respawn — изменяет механику возрождения, теперь после смерти игрок спаунится в пределах 100 блоков от своего места смерти (геймплей)
Big oak tree — генерация огромного дерева (очень красиво) (генерация)
Biome Particle Weather — добавляет в каждый биом свою уникальную новую погоду, по типу песчаной бури в пустыне или сильного ветра в саванне + улучшает уже имеющуюся погоду игры (украшение)
Born in Chaos — глобальный мод на кучу новых мобов, немного новой брони и инструментов, все это в стиле средневековья (глобал)
Bosses of Mass Destruction — добавляет в игру 4 очень круто стилизованных босса: 2 в обычном мире и по одному в каждом оставшемся измерении — ночной лич, мутировавший цветок, огненная перчатка и кто-то в энде (контент)
Break Free + Multi mine — позволяет продолжить копание блока, если случайно навел курсор на другой, а также сохраняет прогресс копания блока при смене инструментов (геймплей)
Brutalbosses — рандомный спавн усиленных мобов со своими способностями. Усложняет геймплей (геймплей)
By go nether / Incendium — новые биомы и структуры в аду (генерация)


(C)
Camera Overhaul — добавляет покачивание камеры вправо или влево в зависимости от движения персонажа, что добавляет динамики и реалистичности
updated — теперь также добавляет небольшую тряску при копании блоков, взрывах и ударах молнии около игрока (украшение)
CarryOn — дает возможность переносить сундуки и мобов напрямую в руках (удобство)
Centered Crosshair — центрирует перекрестье, чтобы оно находилось идеально по центру экрана (изначально оно было не по центру экрана немного чего нах) (украшение)
Chunky - позволяет предзагружать чанки в мире путем введения определенных команд (оптимизация, удобство)
Chunk loaders — добавляет крафт штук, которые прогружают чанки (может быть полезно для разного рода ферм) (удобство)
CleanCut — теперь трава и прочие блоки, не имеющие коллизию, не будут мешать игроку ударить моба (удобство)
Clumps — опыт в одну капельку (удобство, оптимизация)
Configured — позволяет изменять конфиг модов прямо в игре, только для Forge (удобство)
Controlling — помогает со всем, что связано с биндами в игре (удобство)
Combat Roll - добавляет возможность рывка или же переката на alt, позволяя удобнее уклоняться от атак (геймплей)
Continuity — добавляет поддержку соединения блоков и их света для шейдеров (украшение, библиотека)
Corpse — после смерти игрока остается его труп, который также можно обыскать, чтобы вернуть свои вещи на те же места, где они были изначально (геймплей)
Curious Lanterns — добавляет возможность повесить лампу себе на пояс, при этом лампа будет излучать динамический свет (удобство)
Customizable elytr — можно красить элитры (украшение)


(D)
Damage Numbers — самый адекватный мод на показ урона по мобам, потому что урон хорошо видно даже издалека (удобство)
DashLoader — значительно ускоряет запуск Minecraft путем кеширования информации о модах.
Примечание 1: некоторые моды не поддерживают кеширование, но при этом Minecraft все равно будет запускаться и работать, но запуск будет медленнее.
Примечание 2: при первом запуске игры она будет запускаться все так же медленно, потому что нужно создать кеш в первый раз, дальнейшие запуски будут намного быстрее.
Delightful burgers — крафт бургеров (контент)
Disable Double Tap to Sprint — убирает надоедливую функцию бега на двойное нажатие W, в игре на это есть кейбинд (удобство)
Disenchanting — стол разочарования, который переносит зачарования из оружия в книги. Мод имбалансный, перед использованием измените крафт этого стола на более тяжелый (контент, удобство)
Dungeon Crawl — генерирует случайные подземелья со входом в виде башни, со случайным лутом по миру игры (контент)
Dungeon Now Loading — добавляет 4 больших подземелья в игру, в каждом из которых в конце будет босс (контент)
Dungeons and Taverns — добавляет много структур с пилладжерами на поверхности и под землей, включая данжи (генерация)
Dungeons Content — переносит почти весь контент в виде мобов и биомов из игры Minecraft Dungeons в Minecraft (контент)
Durability tooltip — видно прочность инструмента в числах (удобство)
Dynamic Crosshair — меняет прицел в зависимости от того, на что в данный момент он наведен (удобство)
DSWG Colors of Sky — дает каждому биому свой уникальный цветокор неба, что делает игру намного атмосфернее (украшение)


(E)
Easy Anvils — наковальни больше не расходуют все больше опыта за многократную починку предмета + теперь их можно ремонтировать железными блоками + предметы всегда остаются внутри наковальни (удобство)
Easy Magic (не стакается с Apotheosis) — позволяет рероллить выпавшие зачарования на столе зачарований, а также вещи и лазурит на столе сохраняются (удобство)
Easy ShulkerBoxes — улучшает интерфейс использования шалкеров, позволяя взаимодействовать с ним из инвентаря, что делает его конкурентом для рюкзака (удобство)
Effective — добавляет некоторые визуальные эффекты, наподобие Minecraft трейлера, например для воды, сундуков под водой, светлячков на болотах и так далее (украшение)
Electrodynamics — глобальный мод на добавление всякой электрической шняги для улучшения плавки незерита и создания нано брони (глобал, техно)
Embedium — хороший мод на оптимизацию майна на Forge (оптимизация)
Embedium Dynamic Light — позволяет работать моду на лампу на поясе, также добавляет динамическое освещение (удобство, геймплей)
Ember's Underground Rooms - теперь при копании в шахтах можно случайно наткнуться на различные комнаты с мобами и ресурсами (контент)
Enchanced Celestials — добавит 2 новых события, такие как урожайная и кровавая луна. Во время урожайной посевы будут расти намного быстрее, во время кровавой спаунрейт мобов будет увеличен в 3-4 раза (геймплей)
Enchantment Descriptions — описания зачарований (удобство)
Enchantment Info - показывает на какой предмет можно наложить выбранное зачарование (удобство)
Endless Music — делает фоновую музыку Minecraft полностью настраиваемой относительно пауз между треками (украшение)
End Remastered - теперь для активации порталла в энд нельзя использовать око края, теперь нужно найти как минимум 12/16 глаз для активации портала, глаза находятся либо в сундуках ванильных структур, либо при убийстве некоторых сильных мобов, а некоторые даже крафтятся (геймплей)
*примечание: СТАВИТЬ В КАЖДУЮ СБОРКУ, ЛУЧШИЙ МОД EVER
Enemy Banner — после убийства 50 мобов с них выпадает баннер, который дает баффы как в террарии, то есть увеличение урона по мобу и увеличение добычи с моба (геймплей)
End's Phantasm — изменяет метод прохождения Энда. Изначально игрока будет спаунить на дальних островах, вход на которые раньше был закрыт до убийства дракона. Исследуя эти острова, нужно найти портал на арену с драконом + добавляет пару новых биомов Энда (геймплей)
Equipment Compare — позволяет сравнить 2 предмета между собой, наведя на новый предмет и нажав Shift (удобство)
Eternal Starlight — добавляет некоторые новые структуры, измерения и боссов, которые очень хорошо проработаны. Мод под RPG-сборки (контент)
Exposure — камера и возможность быть фотографом в Minecraft (контент, украшение)
Experience jars — бутылочки, где можно сохранить свой опыт (контент, удобство)
Explorer's Compass — компас, который позволяет находить нужную структуру в мире (контент, удобство)
Explorify — добавляет разные небольшие новые структуры, которые идеально вписываются в мир (генерация)
Euphoria Patches — дополнение для шейдеров Complimentary, которое добавляет очень много крутых визуальных эффектов по типу свечения портала в Энд, кастомизации лавы, цветного освещения блоков и так далее (украшение)


(F)
Fast boot — ускорение загрузки игры (оптимизация)
Faster Random - ускоряет генерацию случайных чисел, которые отвечают за генерацию мира игры и еще кучи других действий в мире (оптимизация)
FastLoad/FastQuit - моды, которые в 2 и более раз ускоряют заход и выход в мир, благодаря оптимизации рендеринга мира и его сохранению в фоновом режиме (удобство)
Fireproof Boats — добавляет лодки из адской древесины, которые способны передвигаться по лаве (геймплей)
Fog — делает более красивый туман, работает во всех измерениях (украшение)
Fog Looks Good Now — улучшает туман, делая его намного красивее и реалистичнее (украшение)
Friends&Foes - добавляет в игру всех мобов, которых не выбрали на голосовании mojang (контент)
FTB Chunks — очередной мод на миникарту, но в нем есть фича защиты чанков от повреждения мобами (геймплей)
Fruits delight — деревья, с которых падают фрукты. Олегсей (контент, украшение)
Fantasy Armor/Weapons - моды, добавляющие крутые виды средневековой брони и оружия, которые получаются из незеритовых приспособлений, меняет только внешний вид и ничего более (украшение)


(G)
Geophilic — меняет подход к генерации лесов и делает их более красивыми (украшение, генерация)
Geophilic Reforged - дополнение к моду geophilic, теперь улучшает все биомы игры, а не только леса (украшение, генерация)
Goblin Traders — добавляет спавн гоблинов торговцев по миру с торгами на лучшие зачарования, недоступные в ванильной игре (геймплей, контент)
GoProne — возможность ползти (удобство)
Gravestone Mod — добавляет могилу после смерти игрока и дает ему бумажку с координатами смерти (удобство)
Gravestone x Curious API compat — возвращает на места не только все вещи в инвентаре, а еще и артефакты (удобство)
Gui Effect Timer — видно, сколько будет идти эффект, без необходимости открывать инвентарь (удобство)


(H)
Hole filler mod — добавляет крафт сфер из разного материала, которые заполняют собой дыры (контент, удобство)
Horses can swim — лошади теперь не такие бесполезные (удобство)
HT's TreeChop — самый балансный мод на мгновенное срубание дерева (удобство)


(I)
Ice and Fire — глобальный мод на новых боссов в виде драконов, циклопов, сирен, медузы Горгоны и так далее + куча новой брони и инструментов (глобал)
Ice and Fire - аддон к iceandfire, добавляет разные скиллы (контент)
Immersive aircraft — самолеты, дирижабли и всякие приблуды к ним (контент)
Immersive machinery — аддон к Immersive Aircraft, добавляет еще транспорт. Например, бур (контент)
Immersive UI — добавляет крутые анимации перемещения и выбора предметов в инвентаре (удобство)
Immersive Weathering - добавляет кучу механик, которые делают мир живее, например запыление песком пустынных камней, обугливание дерева при горении, рост травы, образование сосулек на на крышах домов, растущий мох на другие блоки и так далее (геймплей, украшение)
Improved Mobs - все мобы игры теперь постепенно усиливаются с каждым прожитым днем, то есть увеличивают свой урон, хп и скорость, так же все мобы теперь могут использовать предметы, которыми раньше не могли пользоваться, например динамит или эндер жемчуг (мод лучше настроить на mobGriefing = off так как все мобы теперь могут сломать тебе дом и ебало в придачу) (геймплей)
Improvable Skills — теперь в разных сундуках можно находить свитки, позволяющие прокачивать 10 новых навыков. Они все пассивные, и каждый довольно полезен (например, скорость копания или урон в PvP), прокачивать их можно через книгу навыков (геймплей)
Infinity Music — делает эмбиент и музыку с дисков Minecraft постоянной и не заканчивающейся, все настраивается (удобство)
Inventory Profiles Next — добавляет возможность быстрой сортировки сундуков и инвентаря + возможность быстрого перемещения всех предметов в сундук (удобство)
Invmove — позволяет передвигаться даже с открытым инвентарем (удобство)
Iron barrels — добавляет улучшение бочек (удобство, контент)
Iron bookshelves — добавляет улучшение книжных полок (удобство, контент)
Iron Chests — добавляет улучшение сундука как хранилища (удобство, контент)
Iron ender chests — улучшение эндер сундуков (удобство, контент)
Iron Furnaces — добавляет улучшение скорости плавки печек (удобство, контент)
Iron Gem's Jewelry — добавляет в игру кучу разных украшений, которые крафтятся с помощью гемов, продающихся у жителей. Каждое из украшений дает свой уникальный эффект (геймплей)
Iron ladders — добавляет улучшение лестниц (удобство, контент)
Iron shulker box — добавляет улучшение шалкеров (удобство, контент)
Iris Shaders — добавляет поддержку шейдеров в моды по типу Sodium или Embedium (библиотека, украшение)
Item Highlighter — показывает звездочкой новые подобранные предметы в инвентаре (удобство)
Item Scrapper — добавляет стол для разборки предметов, где разбирая предмет ты бьешь по нему молотом с прикольной анимацией (удобство)
ItemPhysic - теперь предметы лежат на земле как и должны, а не левитируют в воздухе, так же с этим модом можно настроить как игрок сможет подбирать предметы, например предметы будут подбираться только при присяде или только если тыкнуть по ним пкм, когда они на земле (геймплей)


(J)
Jade — объединяет в себе функции показа названия блока и из какого он мода, а также отображения имени и хп моба при наведении (удобство)
Journeymap — лучшая мини-карта для Minecraft (удобство)
Just Enough Items — позволяет видеть все предметы и их крафты в инвентаре (удобство)


(K)
Keep Some Inventory – после смерти оставляет инструменты и броню на игроке, при этом все другие предметы выпадают, теперь они не разлетаются во все стороны как в ваниле, а собираются в 1 блок, позволяя вещам случайно не сгореть в ближайшей лаве (геймплей)


(L)
Larion World Generation - изменяет генерацию мира на более рпгшную, делая горы выше, а реки длиннее (генерация)
L enders Cataclysm – добавляет новых проработанных боссов с уникальным лутом (контент)
Legendary Creatures – добавляет новых враждебных мобов, по типу пугала, которое может напасть на тебя если ты собираешь чужие посевы, слизней, скорпионов и так далее (контент)
Let Me Despawn - теперь мобы с экипированной броней или предметами могут деспауниться (оптимизация)
Linear Progression – все, что делает этот мод, меняет крафт око эндера, теперь для его крафта нужно посетить подводный манумент, дворец испытаний, особняк пилладжеров, древний город вардена ну и конечно же незер, это будет весьма кстати, чтобы увидеть весь контент, который добавляет сборка + нельзя заспидранить игру (геймплей)
Lios overhauled villages – улучшение деревень, выглядят круче (генерация, украшение)
Lithium – оптимизирует работу сущностей и всех механик майнкрафта, работает вместе с sodium или embedium (оптимизация)
Load my chunks – оптимизация прогрузки чанков (оптимизация)
Lootbeams – добавляет редким предметам майнкрафта лучи нужного цвета, которые подсвечивают их в выброшенном состоянии (украшение, удобство)
Lootr – в многопользовательской игре делает все сундуки уникальными для каждого игрока (удобство)
LUMINOUS – улучшает все биомы игры, добавляя доп элементы по типу камешков, грибов на деревьях, пару новых мобов по типу оленей и немного улучшает генерацию мира (украшение)


(M)
Majrusz's Progressive Difficulty – добавляет систему прогрессии игры, схожей с terraria, когда игрок попадает в ад, то мир усложняется, когда в край, то он становится еще сложнее, в кратце, появляются группы мобов с их предводителями, так же добавлен новый ивент, как рейд нежити при убийстве достаточного количества нежити (контент)
Man of many planes – самолеты (контент)
MC Dungeons Enchanting – меняет систему зачарований на систему из minecraft:dungeons (контент)
Mekanism – очередной глобальный техномод, дополняет electrodynamix (глобал, техно)
Metal bundles – 2 жизнь для мешочков. один из вариантов удобного хранилища (контент)
Memory Leak Fix - фиксит утечки памяти в больших сборках (оптимизация)
Modern Industrialization - очень глобальный техно мод, который добавляет свою систему прогрессии по игре, кучу реально полезных механизмов и способов автоматизации (контент)
Modern Industrialization Sound Addon - теперь почти каждое действие мода modern industrialization имеет звуковой эффект (удобство)
ModernFix - фиксит ебучее зависание сборки спустя какое-то время игры, должен быть в каждой сборке (супер-оптимизация)
Model Gap Fix – исправляет микро дыры между текстурами предметов в руке (украшение)
Mofu's better end / Mofu's Broken Constellation - лучший мод на дополнение энда, добавляет кучу новых разнообразных биомов, структур и боссов, скорее всего не совместим с другими модами на доп контент в энде (контент)
Moog's Soaring Structures – генерация летающих островов с разными строениями (генерация, украшение)
More Artifacts – добавляет еще 30 новых артефактов из игры террария, которые в некоторых случаях могут быть соединены между собой (геймплей)
More Cosmetics – добавляет меню, где можно нацепить на персонажа разные косметические штуки, по типу накидок, шляп, щитов и так далее (украшение)
More Culling – убирает рендеринг не только блоков, которые не видит игрок из-за закрытия их другими блоками, а так же убирает рендеринг всего, что не видит игрок (оптимизация)
MoreVanillaArmor – добавляет еще около 10-15 новых сетов брони из ванильных материалов, некоторые из них обладают уникальными эффектами (контент)
Mouse Tweaks - улучшает работу мышью в игре (удобство)
Multiplayer Bosses – теперь боссы в мультиплеере будут иметь хп в зависимости от игроков + с них выпадает мешочек с лутом отдельно для каждого игрока (геймплей, удобство)
Music Sync – синхронизирует музыку игры у всех игроков на сервере (украшение)
Mutant monsters – добавляет усиленные вариации монстров - мутантов (геймплей)
Medieval Music - добавляет в игру около 40 новых саундтреков в стиле средневековья, рекомендуется использовать вместе с Biome Music (украшение)


(N)
Nature's Compass – компас, который позволяет находить нужный биом в мире (контент, удобство)
Not Enough Animations – добавляет новые анимации некоторым действиям, по типу просмотра карты, лазания по лестнице, поедания еды и т. д. (украшение)
Noisium - значительно ускоряет прогрузку новых чанков при генерации мира и во время его исследования, совместим с любыми модами на генерацию (оптимизация)
Nyf's Spiders - теперь пауки могут лазить по любым наклонным поверхностям, как в реальной жизни, так же теперь их моделька правильно поворачивается относительно этих поверхностей (геймплей)


(O)
Obscure Tooltips – делает вид подсказок предметов намного красивее, так же показывает рендер 3д модельки этого блока/предмета в мире (украшение)
Oceanic Realms - наполняет подводный мир игры фауной, по типу акул, мелких групп рыбок, крабов и так далее (контент)
One Key Miner – дает возможность выкопать всю жилу руды при нажатии shift + лкм, немного экономит время (геймплей, удобство)


(P)
Packet Fixer - фиксит переполнение nbt тегов в больших сборках (оптимизация)
Panda's Extra Details – добавляет парочку новых анимаций, например анимация открытия двери и люка
Paraglider – добавляет параглайдер (слабый аналог элитр) и статуи в деревнях, в которых можно раскачать свое хп до 60 с помощью орбов, которые падают со спавнеров. мод использовать как облегчающий геймплей в сложных сборках (геймплей, контент)
Particular Reforged - добавляет некоторые новые эффекты и частицы, например всплекс воды при падении туда моба, эффект водопада, светлячков, падающие листья, пещерную пыль, пузырьки из сундуков под водой и так далее (украшение)
Passive Shield – теперь щит не будет видно во второй руке до его применения, так же теперь щит добавляет некоторое сопротивление урону при ношении (геймплей)
Pet names – рандомные имена прирученным питомцам (украшение)
Perception - мод, добавляет анимацию следа за каждым из ванильных проджектайлов, по типу стрел, глаз эндера, черепов иссушителя и так далее (украшение)
Phosphor – оптимизирует составляющую освещения в minecraft и фиксит некоторые баги, связанные с ним, так же позволяет быстрее загружать чанки (оптимизация)
Ping Wheel – добавляет возможность пинговать своим друзьям на место, которое ты хочешь указать (удобство)
Polymorph – если вдруг какие-то 2 мода сделали один и тот же рецепт крафта на 2 разных предмета, позволяет переключаться между ними в верстаке, что очень выручает (удобство)
Potion Rings – добавляет кольца дающие базовые эффекты маяка (геймплей)
Pretty Rain – дополняет дождь и снег в майнкрафте, например теперь дождь будет стекать по стенам и на воде будут видны волны от дождя, снег теперь завихряется от ветра, а в пустыни теперь вместо отсутствия дождя идет пустынная буря (украшение)
Progressive Bosses - сильно усложняет всех ванильных боссов игры, добавляя им новые атаки и эффекты (контент)
Pufferfish's Skills – добавляет дерево улучшений персонажа, по типу ускорения копания, увеличения урона и так далее (геймплей)


(Q)
Quality Food – добавляет всей еде из игры что-то по типу тира редкости, который влияет на то, насколько еда на самом деле будет полезна для игрока, например будет давать больше сытости или давать особые эффекты, мод совместим с farmer's delight (геймплей)
Quark - мод представляет собой набор полезных улучшений игры, например подсказок о предметах, так же сравнение снаряжения тоже присутствует, позволяет открывать сразу обе двери при нажатии на двойную дверь, блок кормушки для животных для их авторазведения, один новый биом и моб в пещерах, связанные с добычей руды, возможность ставить вертикальные полублоки, стамеска позволяет ставить блоки рандомно, выбирая из тех, которые находятся в хотбаре (удобство)
*примечание: СТАВИТЬ ВО ВСЕ СБОРКИ, ЛУЧШИЙ МОД EVER


(R)
Re:Deco – добавляет очень много новых блоков для обустройства дома, например камодов или баночек с растениями (украшение)
Reacharound – улучшает механику строительства, позволяя ставить блоки в воздухе, в недосягаемых местах и еще много чего (геймплей, удобство)
Realm RPG: Fallen Adventures – добавляет во всех измерениях майнкрафта падших скелетов прошлых путешественников, выглядит очень красиво и вписывается в любую рпг сборку (украшение)
Remove Block Outline – убирает обводку блока при наведении на него, может быть полезно для улучшения восприятия игры (украшение)
Remove Reloading Screen – убирает надоедливую анимацию при смене текстурпаков или шейдеров (удобство)
Responsive Shields - убирает бесячую задержку начала работы щита при его применении, она составляет 5 тиков (удобство)
Respawning Animals – теперь мирные животные так же могут деспауниться и спаунятся немного чаще (удобство, геймплей)
Retraining – реролл торгов у жителя (удобство)
RPG Hud - изменяет интерфейс игрока под рпг стиль, требует хорошей настройки конфига для удовлетворительного результата (украшение)
RightClickHarvest – теперь можно нажать ПКМ на посевы и они соберутся и посадятся одновременно (удобство)


(S)
Serene Seasons - теперь в игре есть система смены сезонов, меняется не только погода, но и блоки вокруг, изменяя свой оттенок (геймплей, украшение)
Serious Player Animations – улучшает все анимации игрока: бега, ходьбы, прыжков, копания и так далее (украшение)
Simple Uncrafting Table – позволяет просто и быстро разобрать любой предмет из игры на его составляющие, включая любой модовый предмет (геймплей)
SkinChanger/SkinRestorer – позволяет менять скины на пиратском сервере (удобство)
SleepWarp – теперь когда игрок спит, время не скипается, а сильно ускоряется. Если этот мод стоит на сервере, то время сильнее ускоряется в зависимости от числа спящих игроков (удобство)
SmoothMenu Refabricated – убирает ограничение частоты кадров в главном меню игры, делая его плавнее (украшение)
Smooth Skies - изменяет небо, делая переход от ночного времени к дневному и наоборот намного более плавным + фиксит визуальные баги неба (украшение)
Snowy tents – маленькие лагеря в зимних биомах (генерация)
Sodium – хороший мод на оптимизацию майна на fabric (оптимизация)
Sophisticated Backpacks – бэкпаки с улучшениями, но без доп баффов игрока (контент, удобство)
Special mobs – усиление мобов за счет увеличения их разнообразия. Усложняет геймплей (геймплей)
Spelunkery – добавляет вариации руд для андезита, диорита и гранита, также добавляет новые точки интереса в пещеры (контент)
Spider Caves – добавляет биом паучьих пещер из игры Terraria (контент)
Spooky paintings – 27 новых картин (украшение, контент)
Stackable potions – зелья стакаются (удобство)
StepItUp – позволяет использовать прыжок для того, чтобы забираться на высоту в 1 блок (геймплей)
Subtle Effects – добавляет в игру много доп. частиц для блоков и действий, которым их не хватает: например, пыль сзади игрока от бега, искры от костра и огня душ, пыль светокамня на блоках и так далее (украшение)
Swing Trough Grass – альтернатива мода CleanCut на forge, позволяет бить врагов сквозь траву (удобство)
Simply Swords – добавляет кучу вариаций оружия ближнего боя, полностью совместим с Better Combat (контент)


(T)
Table Of Experience – добавляет стол, способный разбирать ненужные предметы на пузырьки с опытом (удобство)
Tax's Tree Giant – добавляет в каждый биом, имеющий деревья, свою разновидность огромного дерева (которые лучше, чем твой ебаный мод на дуб, Саня) (украшение)
Terra Entity – добавляет в игру некоторых боссов из игры Terraria (и также Calamity мода), все они хорошо проработаны и анимированы (контент)
Terralith – добавляет около 100 новых биомов, используя ванильные блоки майнкрафта (есть поддержка Geophilic) (генерация)
The Frozen Kingdom – зимний данж с неплохим лутом и сложными противниками (генерация)
The graveyard – данжи, блоки, оружие, босс (глобал)
The Lost Castle - теперь в мире редко генерируется огромный замок разбойников с хорошим лутом, примерно с шансом особняка в темном лесу (контент)
The Age of Ores - добавляет около 200 новых руд в мир игры, которые можно комбинировать между собой, так же добавляет столько же новых видов инструментов и брони (контент)
*примечание: не рекомендуется использовать с модами по типу electrodynamics, во избежание насера руд в шахте
Tinkers' Construct - добавляет в игру систему создания своего оружия с нуля, которое можно полностью кастомизировать под свои нужды с помощью шаблонов (контент, геймплей)
Tom's Simple Storage – лучшее хранилище для вещей по типу ME-системы (удобство, контент)
Tool Tip Fix – делает так, что огромные подсказки на предметах (по типу описания зачарования) теперь занимают меньше места (удобство)
ToroHealth Damage Indicators – при ударе по мобу показывает твой урон (удобство)
Tough as Nails - добавляет в игру механику температуры и жажды, теперь за всеми этими показателями нужно следить, чтобы не умереть (геймплей)
Trading post – объединяет все торги в некотором радиусе в один торговый блок (удобство, контент)
Trade Cycling - более удобный мод на реролл торгов у жителей (удобство)
Traveller's Titles – теперь при заходе в новый биом на экране будет писаться его название (украшение, удобство)
Traveler's Backpack – бэкпаки с доп. баффами игрока и возможностью хранить жидкости (удобство, контент)
Twigs – добавляет много новых блоков, которые идеально подходят для строительства дома (контент)


(U)
Unseen world – новый биом, оружие, мобы (глобал)


(V)
Village Spawn Point - теперь при создании нового мира игрок всегда будет появляться в деревне (удобство)


(W)
Waystones – можно сделать/найти в мире камни, которые связаны между собой. Между ними можно перемещаться (удобство, генерация, контент)
Weather Storms & Tornadoes - мод который добавляет новое погодное событие как шторм, в котором призывается торнадо, которое может разьебать тебе базу (возможно с mobGriefing = false не может) (контент, геймплей)
What Durability? – убирает возможность потери прочности у любых предметов, которые её имеют (геймплей)
Wthit – показывает название блока и из какого он мода (удобство)


(X)
X-HP – крутой мод на отображение хп у мобов (удобство)


(Y)
YUNG's Cave Biomes – добавляет новые биомы в пещерах, в которых есть пара новых мобов, при этом биомы состоят из ванильных блоков (контент)


(Z)
Zombie Awareness - мод сильно улучшает искуственный интелект обычных враждебных мобов, теперь они могут выслеживать игрока по крови, свету, звукам и так далее, так же теперь враждебных мобов спаунится немного больше и они чаще встречаются группами (геймплей)
*примечание: вообще не факт, что совместим с модов AI Improvements
Zombie Survival Kit - мод сделан специально для сборок с зомби апокалипсисом, тут есть много новых оружий, ловушек, брони и приспособлений для борьбы с зомби, так же в моде есть руководство (контент)
